MMMMMMMMMM
MPPPCCPPMM
MFFPRPPFFM
MFPPRPPFCM
MFPCCCCPCM
MFPCCCCCCM
MFPPRPPFFM
MFFPRPPFFM
MMPPCCPPMM
GSRGCMMMMZ
