RRRRRRRRRRRRRRWRRRRRRRRRRRRRRRRR
TRTRTRTRTRTRTRWRTRTRTRTRTRTRTRTR
RRRRRRRRRRRRRRWRRRRRRRRRRRRRRRRR
RRRRRRRRRRRRRRWRRRRRRRRRRRRRRRRR
CCCCCCCCCCCCCCWCCCCCCCCCCCCCCCCC
OOOOOOOJDCCCCCWCCCCCCCCCCCCCCCCC
AAAAAAAYVDCCCCWCCCCCCFPOOOOOOOOO
AAAAAAAYVVDCCCWCCCCCFVUAAAAAAAAA
IIIIIIIKVVVDCCWCCCCFVVUAAAAAAAAA
WWWWWWW2VVVVRRWRRSRVVVUAAAAAAAAA
WWWWWWWW2VVVRRWRRRRVVVLIIIIIIIII
WWWWWWWWW2VVRRWRSRRVV3WWWWWWWWWW
WWWWWWWWWW2VSRWRRRRV3WWWWWWWWWWW
WWWWWWWWWWW2RRWRSRR3WWWWWWWWWWWW
GGGGGGGGGGGGGGWGGGGGGGGGGGGGGGGG
GGGGGGGGGGGGGGWGGGGGGGGGGGGGGGGG
GGGGGGGGGGGGGGWGGGGGGGGGGGGGGGGG
GGGGGGGGGGGGGGWGGGGGGGGGGGGGGGGG
