MMMMMMMMMM
MPPPCCPPMM
MFFPRPPFFM
MFPPRPPFFM
MMMMMMMMMM
MMMMMMMMFM
MFPPRPPFFM
MFFPRPPFFM
MMPPCCPPMM
MMMMMMMMMZ