MMMMMMMMMM
MPPPCCPPMM
MFFPRPPFFM
MFPPRPPFFM
MFPCCCCPFM
MFPCCCCPFM
MFPPRPPFFM
MFFPRPPFFM
MMPPCCPPMM
MMMMMMMMMZ
