MMMMMMMMMM
MPPPCCPPMM
MFFPRPPFFM
MFPPRPPFFM
MMMMCMMMMM
MMMMRMMMFM
MFPPRPPFFM
MFFPRPPFFM
MMPPCCPPMM
MMMMMMMMMZ
