RRRRRRRRRRRRRRRRRRRRRRRRRRRRRRRR
TRTRTRTRTRTRTRTRTRTRTRTRTRTRTRTR
RRRRRRRRRRRRRRRRRRRRRRRRRRRRRRRR
RRRRRRRRRRRRRRRRRRRRRRRRRRRRRRRR
CCCCCCCCCCCCCCCCCCCCCCCCCCCCCCCC
OOOOOOOJDCCCCCCCCCCCCCCCCCCCCCCC
AAAAAAAYVDCCCCCCCCCCCFPOOOOOOOOO
AAAAAAAYVVDCCCCCCCCCFVUAAAAAAAAA
IIIIIIIKVVVDCCCCCCCFVVUAAAAAAAAA
WWWWWWW2VVVVRRRRRSRVVVUAAAAAAAAA
WWWWWWWW2VVVRRRRRRRVVVLIIIIIIIII
WWWWWWWWW2VVRRRRSRRVV3WWWWWWWWWW
WWWWWWWWWW2VSRRRRRRV3WWWWWWWWWWW
WWWWWWWWWWW2RRRRSRR3WWWWWWWWWWWW
GGGGGGGGGGGGGGGGGGGGGGGGGGGGGGGG
GGGGGGGGGGGGGGGGGGGGGGGGGGGGGGGG
GGGGGGGGGGGGGGGGGGGGGGGGGGGGGGGG
GGGGGGGGGGGGGGGGGGGGGGGGGGGGGGGG