MMMMMMMMMM
MPPPCCPRRM
MFFPRPPRFM
MFPPRRRRFM
MMMMRMMMFM
MMMMCMMMFM
MRRRRPPFFM
MFFPRPPFFM
MMPPCCPPMM
MMMMMMMMMZ
