MMMMMMMMMM
MRRRCCPPMM
MFFPRCPFFM
MFPCRCPFFM
MFPCMRCPFM
MFCCCCCPFM
MFCMMCPFFM
MFCCCCPFFM
MMPPCCPPMM
GSRGCMMMMZ
