MMMMMMMMMMMMMMMMMMMMMMMMMMMMMMMM
MPPPPPPPPPPFFFPCCPPPPPPFFPPPPPPM
MRRFFFFFFFFFCCCCCFFFFFCPPPPPPPPM
MFFFFPPPPFFFFPPPPPFFFCCFFFFFFFFM
MCCCFFFFFFFPPPPPPCCCFFFFFCFFFCCM
MPPPPPPCCCCPPPPPCCCPPPPPPPPPPPPM
MRRRRRRRRRRRRRRRRRRRRRRRRRRRRRRM
MFFFFFFFFFCCCCCFPPFFCCCFPPPFFFFM
MCCCCCCFFFPPPPPPCCCFFFFFFFFCCCCM
MPPPPPPPCCCCCCCPPPPPPPPPPPPPPPPM
MRRRRRRRRPPPPPPPPPPPPPPPPPPRRRRM
MFFFFFFFFFCFFPPPPPPPPPFFFFFFFFFM
MCCCPCPFFPCCPFPPFCPFCCCCCCCCCCCM
MPFFPPPPPPPPPPPPPPPPPPPPPPPPPPPM
MRRRFFFRRRFFFFFFFFFFFRRRRRRRRRRM
MFFFFFFFCCCCFFFFFPPPPPFFFFFFFFFM
MCCCCCCPPPPPPCCCFFFFPPPCCCCCCCCM
MMMMMMMMMMMMMMMMMMMMMMMMMMMMMMMM